1111111111111111111111111111111
10000000000010L00001110000E1111
111111100001111000L000111000001
10000000C00000110000011100C0011
1000000000001000000111000001111
11111110L0011110000000001000001
10000000C00000110000011100C0011
1P00000000001000000111000001111
11111110000111100L0L00011000001
10000000000010L0000111000001111
111111100001111000L000111000001
10000000C00000110000011100C0011
1000000000001000000111000001111
11111110L0011110000000001000001
1111111111111111111111111111111