1111111111111111111111111111111111
1E00000L00000000C00000C00000000001
10100101001000001010010000L0010101
1010010010101010001001000000010101
1P0000000C00CL000000L000000L0000C1
1111111111111111111111111111111111